pricing -> PricingComponent (AppRoutes)
portfolio -> PortfolioComponent (AppRoutes)
sitemap -> SitemapComponent (AppRoutes)
about -> AboutUsComponent (AppRoutes)
contact -> ContactUsComponent (AppRoutes)
privacy-policy -> PrivacyPolicyComponent (AppRoutes)
terms-of-service -> TermsOfServiceComponent (AppRoutes)
coupon -> CouponComponent (AppRoutes)
faq -> FaqComponent (AppRoutes)
cookies-policy -> CookiesPolicyComponent (AppRoutes)
job-application -> JobApplicationComponent (AppRoutes)
user-guides -> UserGuidesComponent (AppRoutes)
careers -> CareersComponent (AppRoutes)
blog -> BlogNewsComponent (AppRoutes)
blog/:categoriesId -> BlogNewsCategoriesComponent (AppRoutes)
blog/:categoriesId/:blogId -> BlogComponent (AppRoutes)
 -> HomepageComponent (HomeRoutes)
 -> ToolsComponent (ToolsRoutes)
simple_ai_tools/:toolId -> SimpleAiToolComponent (ToolsRoutes)
simple_ai_tools -> SimpleAiToolsComponent (ToolsRoutes)
simple_tools/:toolId -> SimpleToolComponent (ToolsRoutes)
simple_tools -> SimpleToolsComponent (ToolsRoutes)
 -> TutorialsComponent (TutorialsRoutes)
:categoriesId/:tutorialId -> TutorialComponent (TutorialsRoutes)
:categoriesId -> TutorialsCategoriesComponent (TutorialsRoutes)
 -> ServicesComponent (ServicesRoutes)
graphic-design -> GraphicDesignComponent (ServicesRoutes)
ui-ux-design -> UiUxDesignComponent (ServicesRoutes)
web-development -> WebDevelopmentComponent (ServicesRoutes)
mobile-app-development -> MobileAppDevelopmentComponent (ServicesRoutes)
backend-development -> BackendDevelopmentComponent (ServicesRoutes)
mobile-device-repair -> MobileDeviceRepairComponent (ServicesRoutes)
computer-laptop-repair -> ComputerLaptopRepairComponent (ServicesRoutes)
maintenance-upgrades -> MaintenanceUpgradesComponent (ServicesRoutes)
:categoriesId -> ServicesCategoriesComponent (ServicesRoutes)
 -> ShopComponent (StoreRoutes)
product/:slug -> ProductDetailComponent (StoreRoutes)
cart -> CartComponent (StoreRoutes)
checkout -> CheckoutComponent (StoreRoutes)
